15 21
#####################
#     #     #     # #
# ### ### ### ### # #
# #   #   #   #   # #
# # ### ##### ### # #
# #     #     #   # #
### ### # ### ##### #
#   #   #   #     # #
# ### ##### ### ### #
#     #     #   #   #
##### # ##### ### ###
#   # #     #     #E#
# # # ### ##### ### #
#   #     #         #
#####################