16 23
#######################
#     #   #     #     #
# ### ### # ### ### ###
# #   #   #   #   #   #
# # ### ##### ### ### #
# #   #     #     #   #
### # ### ### ##### ###
#   # #   #   #   #   #
# ### # ### ### ### # #
# #     #     #   # # #
# # ##### ### # ### # #
#     #   #   # #   # #
### ### ### ##### ### #
#     #     #     #  E#
# ### # ### # ### ### #
#######################