12 17
#################
#     #     #   #
# ### # ### # # #
#   #   #   # #E#
### ##### ### ###
#     #         #
# ### # ##### ###
# #   #     #   #
# # ####### # # #
#       #   # # #
######### ### ###
#################