10 15
###############
#     #       #
# ### # ### ###
#   #   #     #
### ##### ### #
#     #   #   #
# ### ### ### #
#   #     #E  #
# ##### # ### #
###############