5 7
#######
#     #
# ### #
#   #E#
#######