13 19
###################
#     #     #     #
# ### # ### # ### #
#   #   #   #     #
### ##### ### ### #
#     #     # #   #
# ### # ##### ### #
# #   #   #   #   #
# # ### # # ### ###
#     # # #   #   #
##### ### ### # #E#
#           #     #
###################